Arepas=water,salt,white cornmeal,vegetable oil 
Cheese Bread=olive oil,water, milk,salt,tapioca flour,garlic,cheese,eggs 
Fried Sweet Bananas=bananas,white sugar,cinnamon,butter 
Flan=sugar,water,eggs,sugar,salt,milk,whipping cream,vanilla extract 
Brazilian Acai=frozen açaí puree,bananas,sugar,passion fruit puree, granola
Ceviche=shrimp,limes,tomatoes,red onions,cilantro,jalapeno,salt,pepper,avocado 
Churros=flour,salt,baking powder,unsalted butter,water,vegetable oil 
Tamales=pork shoulder,water,sea salt,chile sauce,corn husks,tamale masa 
Cinnamon Cookies=butter,sugar,ground cinnamon,salt,vanilla extract,flour
Quinoa=quinoa,water 
Lasagna=cheese,noodles,beef,pepper,tomato,wine,oregano,salt 
Pizza=water,yeast,flour,oil,salt,cheese,sauce,basil 
Greek Omelet=tomato,olives,oregano,eggs,oil,pepper,oregano 
Parmigiana=chicken,breadcrumbs,parmesan cheese,garlic,parsley,oil,eggs
Baked Ziti=pasta,oil,sausage,onion,garlic,tomatoes,cheese,salt
Tortellini=tortellini,sausage,tomato sauce,heavy cream,onion,garlic,spinach
Jaegar Schnitzel=pork,oil,eggs,breadcrumbs,mushrooms,noodles
Wienerschnitzel=veal,flour,eggs,cheese,milk,parsley,salt,pepper,nutmeg,lemon
Kofta=bread,lamb,egg,parsley,garlic,cumin,mint,allspices,
Haydari=yogurt,garlic,cream cheese,dill
Jollof Rice = rice,tomatoes,pepper,oil,salt,curry powder,thyme,ginger
Shakshuka = tomatoes,onion,eggs,garlic,oil,paprika,pepper,cumin
Peri Peri Chicken = chicken,paprika,chili powder,lemon juice,garlic,ginger,salt
Key Sir Alicha = oil,onion,salt,garlic,beets,salt,potatoes
South African Yellow Rice = rice,salt,turmeric,sugar,cinnamon,raisins,butter
Chicken Tagine = chicken,flour,broth,honey,olives,oil,lemon,ginger,cinnamon
Bunny Chow = chicken,oil,chickpeas,potatoes,paprika,garlic,ginger,onion
Bobotie = bread,onion,butter,beef,curry paste,cloves,milk,eggs
Ugali = cornmeal,water,salt
Efo Riro = spinach,beef,oil,tomatoes,pepper,onion,broth,salt,black pepper
Black chicken & red date soup=chicken,scallops, jujubes, goji berries
Soy Garlic Chicken Wings=chicken wings,soy sauce,brown sugar,
Pork Ribs=pork ribs,Shaoxing wine,dark soya sauce,rice vinegar
Napa Cabbage Steaks=napa cabbage,oil,soy sauce,agave syrup,paprika
Gochujang Squash=butternut squash,gochujang sauce,sesame oil,
Cold cucumber salad=cucumbers,lao gan ma chili oil,chinkiang vinegar
Curried Spicy Tuna Dip=vegetable oil,sambal,can tuna,coconut milk,sugar
pandan rice=long-grain rice,water,coconut cream
Five-Spice Nuts=vegetable oil,anise pods,cinnamon stick,cashew nuts
Asian Peanut Noodles=spaghetti,peanut butter,green,crushed peanuts
Southern Cheese Grits=grits,water,milk,bouillon,butter,cheese 
Poutine=french fries,gravy,cheese curds
Creamed Spinach=spinach,garlic,milk,butter,onion
Pigs in a Blanket=crescent rolls,mini cocktail wieners,butter
Ambrosia Salad=marshmallow,pineapple,coconut,sour cream,mandarin orange
Bannock=flour,salt,butter,baking powder,milk
Peanut Butter and Jelly Sandwich=peanut butter,fruit preserve,bread
Cornbread=buttermilk,cornmeal,baking powder,eggs
Cobb Salad=chicken,egg,bacon,lettuce,tomato,avocado
Sweet Potato Pie=sweet potato,eggs,pie crust,cinnamon,cream,butter,sugar
